1 1 1 1 1 1 1 1 1 1
1 0 0 0 0 0 0 0 0 1
1 0 0 0 0 0 1 1 0 1
1 0 0 0 0 0 0 0 0 1
1 0 0 1 1 0 0 1 0 1
1 0 0 0 0 0 0 1 0 1
1 0 0 7 0 9 9 0 0 1
1 0 0 6 6 6 9 0 1 1
1 3 3 3 4 A 9 0 1 1
1 1 1 1 1 1 1 1 1 1