1 1 1 1 1 1 1 1 1 1
1 0 0 0 0 0 0 0 0 1
1 0 0 0 0 0 1 1 0 1
1 0 0 0 0 0 0 0 0 1
1 0 0 1 1 0 0 1 0 1
1 0 0 0 0 0 0 1 0 1
1 0 0 B 0 c c 0 0 1
1 0 0 b b b c 0 1 1
1 a a a A C c 0 1 1
1 1 1 1 1 1 1 1 1 1
