1 1 1 1 1 1 1 1 1 1
1 0 0 0 0 0 0 0 0 1
1 0 0 0 0 0 1 1 0 1
1 0 0 0 0 0 0 0 0 1
1 9 0 1 1 0 0 1 0 1
1 9 9 A 0 0 0 1 0 1
1 6 6 7 0 0 0 0 0 1
1 6 0 0 0 0 0 0 1 1
1 3 3 3 4 0 0 0 1 1
1 1 1 1 1 1 1 1 1 1